***********************************
****...........................****
***.............................***
**...............................**
*.....**....**.......**....**.....*
*.....**...****.....****...**.....*
*.....**....**.......**....**.....*
*.....**....**.......**....**.....*
*.....**....**.......**....**.....*
*.....**...******.******...**.....*
*.....**....**.......**....**.....*
*.....**....**.......**....**.....*
*.....**....**.......**....**.....*
*.....**....**.......**....**.....*
*.....**....**.......**....**.....*
*.................................*
*.................................*
**...............................**
***.............***.............***
****............***............****
***********************************
