*************************************************************
*...*.*.......*.........*.......*...*.*.....*...*.....*.....*
*.***.*****.*.*.***.*.*******.*.***.*.*.*.*****.*.*********.*
*.*.*.*.....*.*.*...*...*.*.*.*.*.*...*.*.............*.*...*
*.*.*.***.*.***.***.*.***.*.*.*.*.*.*****.*.***.*******.*.*.*
*.....*...*.*...*...*...*.....*...*.......*...*.*...*...*.*.*
*.***.*.*****.*.***.*************.***.*******.*.*.*.*.*****.*
*...*...*.....*...*...*...............*.......*.*.*.......*.*
*.*.*.***.***.*.***.*****.*.*.***.*********.*********.*.***.*
*.*.*.*...*.*.*.*...*...*.*.*.*.*.....*...*.........*.*.....*
*.***.*****.*.*********.*.*****.***.*****.***.*****.*.*.***.*
*.*.*...*.*.....*.*...*.........*.*...*.*.......*.....*.*.*.*
*.*.*.*.*.***.***.***.***.***.***.*****.*.***.*******.***.***
*...*.*...*.*...*...........*.....*.......*.........*.......*
*.***.***.*.*.*.*.***.*********.*.*.*.***.*.*****************
*.*...*...*...*.....*...*.*.*...*.*.*.*.*.*.*...*.....*.....*
*.*****.*.*.***.*.*****.*.*.*.*****.***.*.*.*.***.*********.*
*...*.*.*...*...*.*...*.*.....*...*.*.*.*.*.......*.*.*.....*
*.*.*.*****.***.***.*****.*.***.***.*.*.***.***.***.*.*.*****
*.*...*.....*.....*.......*.....*.......*...*...............*
*************************************************************